9
20
 XXXXXXXXXXXXXXXXXXX
       X   XXXXXXXXX
 XXXXXXX XXXXXXXXXXX
 XXXXXXX XXXXXXXXXXX
      XX XXXXXXXXXXX
 XXXX XX           X
      XX XXXXXXXXXXX
XXX XXXX           D
XXX       XXXXXXXXXX