9
25
 XXXXXXXXXXXXXXXXXXXXXXXX
       X      XXXXXXXXXXX
 XXXXXXX XXXX XXX     D X
 XXXXXXX XXXX     XXXXXXX
      XX XXXXXXXXXXXXX   
 XXXX XX           XXX  X
      XX XXXXXXXXXXXXX XX
XXX XXXX            XX XX
XXX       XXXXXXXXX    XX