8
20
     XXXXXX   XXXXXX
X XXXXXXXXX X   XXXX
X   XXXXXXX  XX XXXX
X X XXXXXX  XXX XXXX
XXX     X  XXXX   XD
XXX XX X  XXXXX XXX 
XX XXX X XXXXXX   XX
XXXXXX       XX     